#,#,#,#,#,#,#,#,#,#,#,#,#,#,#,#,#,#,#,#
#, , , , , , , , , , , , , , , , , , ,#
#, ,#,#,#,#, , ,#,#,#,#,#, , ,#,#,#,#,#
#, ,#, , , , , , , , , , , , , , , ,#,#
#, ,#, ,#,#,#,#,#,#,#,#,#,#,#,#, ,#, ,#
#, ,#, , , , , , , , , , , ,#, , ,#, ,#
#, ,#,#,#,#,#, ,#,#,#,#, ,#,#,#,#, , ,#
#, , , , , , , ,#, , ,#, , , , , , , ,#
#, ,#,#,#,#, , ,#, , ,#, , ,#,#,#,#, ,#
#, ,#, , , , , ,#, , ,#, , , , , ,#, ,#
#, ,#, , , , , ,#, , ,#, , , , , ,#, ,#
#, ,#,#,#,#, , ,#, , ,#, , ,#,#,#,#, ,#
#, , , , ,#, , ,#, , ,#, , ,#, , , , ,#
#, , ,#,#,#, , ,#,#,#,#, , ,#, ,#,#, ,#
#, , ,#, , , , , , , , , , ,#, , ,#, ,#
#, , ,#,#,#,#,#, , , , ,#,#,#,#, ,#, ,#
#, , , , , , , , , , , , , , , , ,#, ,#
#, ,#,#,#,#,#,#,#,#,#,#,#,#,#,#,#,#, ,#
#, , , , , , , , , , , , , , , , , , ,#
#,#,#,#,#,#,#,#,#,#,#,#,#,#,#,#,#,#,#,#