#,#,#,#,#,#,#,#,#,#,#,#,#,#,#,#,#,#,#,#
#, , , , , , , , , , , , , , , , , , ,#
#, , ,#,#,#,#,#,#, , ,#,#,#,#,#,#, , ,#
#, , ,#, , , , , , , , , , , , ,#, , ,#
#, , ,#, ,#,#, , , , , , ,#,#, ,#, , ,#
#, , ,#, ,#,#, , ,#,#, , ,#,#, ,#, , ,#
#, , ,#, , , , , ,#,#, , , , , ,#, , ,#
#, , ,#, , , , , ,#,#, , , , , ,#, , ,#
#, , , , , , , ,#,#,#,#, , , , , , , ,#
#, , ,#, , , , , ,#,#, , , , , ,#, , ,#
#, , ,#, , , , , ,#,#, , , , , ,#, , ,#
#, , ,#, ,#,#, , ,#,#, , ,#,#, ,#, , ,#
#, , ,#, ,#,#, , , , , , ,#,#, ,#, , ,#
#, , ,#, , , , , , , , , , , , ,#, , ,#
#, , ,#,#,#,#,#,#, , ,#,#,#,#,#,#, , ,#
#, , , , , , , , , , , , , , , , , , ,#
#, , ,#,#,#,#, , , , , , ,#,#,#,#, , ,#
#, , ,#,#,#,#, , , , , , ,#,#,#,#, , ,#
#, , , , , , , , , , , , , , , , , , ,#
#,#,#,#,#,#,#,#,#,#,#,#,#,#,#,#,#,#,#,#
